2,19,19,19,19,19,19,19,19,5
10,28,28,28,28,28,28,28,28,13
18,48,48,48,48,48,48,48,48,21
18,48,48,48,48,48,48,48,48,21
18,48,48,48,48,48,48,48,48,21
18,48,48,48,48,48,48,48,48,21
18,48,48,48,48,48,48,48,48,21
18,48,48,48,48,48,48,48,48,21
42,43,43,43,43,43,43,43,43,45